BBBBBBBBBBBBBBBBBBBB
BGGGGGGGGGGGGGGGGGGB
BGGGGGGGGGGGGGGGGGGB
BGGGGGGGGGGGGGGGGGGB
BGGGGGGGGGGGGGGGGGGB
BGGGGGGGGGGGGGGGGGGB
BGGGGGGGGGGGGGGGGGGB
BGGGGGGGGGGGGGGGGGGB
BGGGGGGGGGGGGGGGGGGB
BGGGGGGGGGGGGGGGGGGB
BGGGGGGGGGGGGGGGGGGB
BGGGGGGGGGGGGGGGGGGB
BGGGGGGGGGBGGGGGGGGB
BGGGGGGGGGGGGGGGGGGB
BBBBBBBBBBBBBBBBBBBB