WWWWWWWWWWWWWWWWWWWW
WGBGBGGGGGGOGGGBGGGW
WGBGBGGGBGGGGBGBGGGW
WGBBBGGGGGGGGGGBGGGW
WGBGBGGGGGGGGBGBGGBW
WGGGBGGGBGGGGBGBGGGW
WGBGBNGGBGGGGBGBGGGW
WQBGGGGGBGGGGBGBGGGW
WGGGBGGGBGGGGBGBGGGW
WGGGGBBBBGGGGBGBGGGW
WGBGGGGGBGGGGBGBGGGW
WGBGGGGGBGGGGBGBGGGW
WGBGGGGGBGBGGGGGGGGW
WGBGGGGGBBBBGGGGGGGW
WWWWWWWWWWWWWWWWWWWW