BBBBBBBBBBBBBBBBBBBB
BGGGGGGGGGGGGGGGGGGB
BGGGGGGGGGGGGGGGGGGB
BGGGGGGGGGGGGGGGGGGB
BGGGGGGGGGGGGGGGGGGB
BGGGGGGGGGGGGGGGGGGB
BGGGGGGGGGGGGGGGGGGB
BGGGGGBGGGGGGGGGGGGB
BGGGGGGGGGGGGGGGGGGB
BGGGGGBGGGGGGGGGGGGB
BGGGGGGGGGGGGGGGGGGB
BGGGGGGGGGGGGGGGGGGB
BGGGGGGGGGGGGGGGGGGB
BGGGGGGGGGGGGGGGGGGB
BBBBBBBBBBBBBBBBBBBB