B G G G G G G G G G
B G G G G G G G G G
B G E G G G G G B G
B G G G G G G G G G
B B G G G G G G G G
B G G G G G G G G G
B G G G G G G G G G
B G G G G G G G G G
B G G G G G G G G G
B B B B B B B B B B