WWWWWWWWWWWWWWWWWWWW
WGBGBGGGGGGGGGQBGGGW
WGBGBGGGBGGGGBGBGGGW
WGBBBGGGGGGGGGOBGGGW
WGBGBGGGGGGGGBGBGGBW
WGBGBGGGBGGGGBGBGGGW
WGBGBNGGBGGGGBGBGGGW
WGBGGGGGBGGGGBGBGGGW
WGGGBGGGBGGGGBGBGGGW
WGGGGBBBBGGGGBGBGGGW
WGBGGGGGBGGGGBGBGGGW
WGBGGGGGBGGGGBGBGGGW
WGBGGGGGBGBGGGGGGGGW
WGBGGGGGBBBBGGGGGGAW
WWWWWWWWWWWWWWWWWWWW